800 800 800 800 800 800 800 800 800 800 1143 26 48 5 40 8 26 18 17 48 0 20 24 39 24 25 7 37 53 25 10 51 19 21 7 2 61 7 19 60 30 58 52 47 63 32 49 44 5 15 1 54 25 58 18 34 40 28 36 5 23 8 32 26 14 40 36 15 43 26 25 15 8 50 8 51 54 33 0 34 27 49 26 33 19 44 45 59 10 16 49 24 58 52 32 11 1 30 45 39
800 800 800 800 800 800 800 800 800 800 1143 26 37 33 62 4 28 50 24 47 15 59 33 55 43 54 27 60 59 24 10 61 43 17 58 31 49 4 17 18 29 19 13 21 17 50 39 40 2 49 5 35 39 63 59 11 17 9 41 14 11 32 34 35 32 59 12 10 44 16 24 57 17 31 54 8 46 56 0 11 9 45 13 32 13 26 11 8 48 36 59 6 32 25 2 27 39 9 38 51
800 800 800 800 800 800 800 800 800 800 1143 26 23 38 48 59 28 26 42 41 55 3 3 58 21 63 35 35 47 8 61 62 29 35 18 26 34 25 55 30 19 5 45 0 32 10 44 45 16 25 35 41 15 2 7 17 19 12 18 31 10 14 6 60 12 13 11 58 50 8 51 40 11 30 21 53 28 27 47 48 49 58 32 0 63 9 16 8 12 45 39 13 63 40 22 10 36 10 56 55
800 800 800 800 800 800 800 800 800 800 1143 26 6 59 37 63 57 13 9 54 23 48 34 30 17 32 12 46 55 52 43 25 53 52 40 54 53 6 14 41 38 21 27 7 17 18 13 33 6 36 4 51 1 25 49 0 58 10 21 25 38 32 12 29 34 48 22 57 14 53 16 49 44 23 31 50 25 41 63 61 8 42 52 61 5 29 60 59 22 23 20 1 23 61 53 8 57 6 55 15
800 800 800 800 800 800 800 800 800 800 1143 26 50 30 21 47 62 2 59 31 27 57 35 16 7 31 5 22 3 29 12 13 54 35 44 7 28 46 35 22 7 11 42 17 49 42 20 35 9 18 14 20 17 31 37 18 37 14 57 30 45 42 3 57 63 15 51 8 5 17 58 27 16 51 10 48 51 3 52 11 33 11 38 3 20 11 36 10 32 6 37 59 6 10 15 3 5 34 21 17
800 800 800 800 800 800 800 800 800 800 1143 26 38 13 9 63 5 3 17 57 5 53 24 60 35 36 2 23 27 18 9 41 4 39 61 32 12 46 23 38 13 33 6 37 35 2 60 38 55 23 20 9 43 42 34 12 49 44 58 19 18 50 40 13 40 18 13 18 63 14 38 16 49 46 38 27 18 14 45 58 42 38 58 7 32 16 34 24 0 23 45 34 22 42 1 23 32 35 51 8
800 800 800 800 800 800 800 800 800 800 1143 26 19 8 23 22 56 41 58 15 29 40 37 39 45 38 10 21 9 14 57 8 1 15 5 2 1 19 11 31 58 35 10 14 60 23 1 57 10 24 16 40 62 15 54 58 9 33 57 6 28 44 27 58 37 37 14 30 29 5 40 50 53 50 31 60 48 8 23 22 20 9 0 54 56 26 12 40 58 48 11 7 5 6 20 44 53 6 29 6
800 800 800 800 800 800 800 800 800 800 1143 26 46 58 22 6 59 49 13 47 53 28 23 53 17 6 23 35 43 20 19 10 2 40 53 16 44 48 41 1 6 24 12 18 28 9 20 37 22 37 42 39 44 21 34 54 62 59 21 55 42 58 16 48 0 41 22 10 6 41 54 20 1 18 9 37 48 21 61 16 51 17 17 15 45 54 44 35 52 48 35 59 34 2 25 46 36 40 41 54
800 800 800 800 800 800 800 800 800 800 1143 26 3 63 41 36 7 62 47 25 60 18 24 36 15 23 9 58 20 49 15 33 41 56 20 34 11 11 57 5 37 12 20 16 9 63 3 61 43 59 63 13 16 6 37 40 61 2 2 7 40 4 53 4 27 45 30 21 40 22 52 3 25 19 49 50 9 23 42 14 9 35 28 30 26 30 22 40 20 37 45 51 49 8 43 4 40 42 33 12
800 800 800 800 800 800 800 800 800 800 1143 26 15 29 53 61 8 6 47 47 34 7 9 56 39 56 42 61 16 59 8 56 55 21 55 32 41 38 2 15 1 13 34 3 4 63 35 2 37 51 48 50 34 61 63 62 9 41 43 49 13 24 38 60 3 63 12 58 23 13 39 5 24 52 26 56 21 5 27 36 4 55 60 19 13 9 26 62 59 41 5 60 53 33 22 35 20 28 7 26
800 800 800 800 800 800 800 800 800 800 1143 26 10 0 58 13 33 7 54 19 17 59 11 2 48 16 57 46 8 53 35 61 20 32 6 38 5 44 3 29 55 58 47 9 61 45 35 16 18 0 36 9 62 38 3 38 7 61 49 56 9 56 53 7 55 32 9 38 49 28 55 10 48 43 25 58 25 22 41 14 50 54 29 46 37 9 19 26 41 39 23 14 44 14 38 30 3 63 32 3
800 800 800 800 800 800 800 800 800 800 1143 26 46 42 19 38 41 0 26 40 38 10 0 38 45 43 56 6 33 12 46 26 57 22 44 63 9 40 60 55 1 53 33 1 9 23 19 34 60 48 27 46 16 47 31 35 49 35 52 0 5 44 20 2 46 50 21 31 49 1 49 21 9 28 50 8 42 1 55 13 33 9 0 59 33 16 6 12 19 52 18 50 2 18 61 12 47 13 16 6
800 800 800 800 800 800 800 800 800 800 1143 26 48 14 3 29 37 51 56 37 31 35 46 24 56 15 54 5 18 14 24 50 63 36 33 60 40 55 23 19 12 59 35 31 49 23 23 26 25 3 13 55 26 60 48 51 57 35 7 24 12 13 25 0 38 0 32 47 34 32 55 35 51 54 39 30 36 25 35 55 3 13 17 57 57 31 19 8 60 24 32 40 2 61 1 19 9 5 13 32
800 800 800 800 800 800 800 800 800 800 1143 26 15 53 39 15 14 6 6 14 18 40 50 30 15 18 1 60 55 32 18 2 44 16 26 53 55 39 61 3 47 52 12 51 25 48 34 19 25 0 30 3 40 14 38 23 4 40 51 58 44 59 15 2 15 9 51 54 36 28 61 2 6 7 56 24 37 25 45 59 26 4 21 27 48 38 26 12 48 43 12 26 58 12 5 24 57 47 14 32
800 800 800 800 800 800 800 800 800 800 1143 26 7 24 45 44 39 17 18 10 4 42 38 27 33 17 13 48 11 63 1 8 33 52 34 17 4 3 59 36 21 30 29 35 14 17 6 31 4 46 20 43 56 57 33 7 27 26 13 20 16 53 35 31 0 52 25 45 20 46 28 7 23 50 23 13 52 60 63 20 5 47 35 50 0 11 9 29 50 52 12 58 43 17 27 14 61 18 40 1
800 800 800 800 800 800 800 800 800 800 1143 26 9 58 26 56 6 55 26 40 46 57 27 59 0 22 48 51 57 41 8 12 3 59 45 49 41 29 46 5 26 41 26 59 55 11 51 35 49 49 14 48 21 53 24 14 40 0 33 55 58 34 51 56 29 25 30 2 63 9 39 46 9 15 51 27 14 12 0 50 55 7 1 13 26 53 58 58 21 42 61 46 21 19 3 17 23 8 41 42
800 800 800 800 800 800 800 800 800 800 1143 26 58 61 10 20 36 57 32 19 48 21 38 30 61 60 63 38 55 22 52 45 4 34 29 47 9 21 8 3 49 36 40 51 54 54 12 14 62 41 57 9 18 8 16 47 54 22 30 52 50 58 47 3 50 21 22 26 24 48 48 40 12 11 42 32 48 29 38 12 13 56 22 2 13 10 18 57 27 11 18 48 12 36 54 26 43 4 51 60
800 800 800 800 800 800 800 800 800 800 1143 26 24 61 9 6 37 8 59 12 40 31 34 31 37 43 56 41 49 45 8 16 49 25 36 1 21 0 50 62 47 24 33 32 31 5 20 22 52 62 29 14 29 5 16 43 27 33 63 13 22 51 41 61 5 51 62 1 33 36 21 2 28 29 47 30 42 16 18 18 8 54 39 9 19 10 52 21 45 18 59 47 36 10 23 30 50 13 31 11
800 800 800 800 800 800 800 800 800 800 1143 26 33 51 19 40 31 31 61 20 33 52 35 14 63 28 18 21 61 44 11 19 16 36 6 10 25 32 23 14 22 56 14 22 42 62 8 6 43 44 2 30 30 22 30 30 10 31 40 8 41 11 31 60 18 9 56 40 17 42 15 60 37 45 10 31 10 0 51 44 0 51 63 62 1 33 4 60 4 12 46 18 16 48 41 60 20 5 37 57
800 800 800 800 800 800 800 800 800 800 1143 26 63 5 46 5 22 30 50 32 30 38 19 10 48 16 9 61 17 56 29 63 19 63 30 11 47 45 58 9 24 45 57 55 45 15 24 53 53 53 38 19 53 39 27 26 56 50 1 59 48 30 57 26 34 22 43 4 62 35 2 55 53 18 21 61 51 24 52 31 27 27 38 3 35 36 21 7 16 43 33 61 11 21 29 35 35 59 16 11
800 800 800 800 800 800 800 800 800 800 1143 26 47 32 14 14 14 41 20 58 44 4 4 10 54 49 37 40 50 37 13 32 28 29 62 38 40 50 11 32 43 41 39 0 14 38 49 3 58 29 12 20 33 13 42 60 3 13 35 26 2 25 50 56 11 21 17 50 54 45 0 40 14 17 11 16 46 2 30 49 42 28 55 39 63 54 36 28 26 36 44 62 59 45 60 33 17 55 3 22
800 800 800 800 800 800 800 800 800 800 1143 26 44 38 6 58 35 50 5 63 45 22 41 51 1 15 23 47 56 23 58 44 42 5 41 25 56 40 9 13 33 35 60 42 50 28 3 57 62 22 4 36 5 44 2 61 45 17 3 15 43 35 51 33 63 55 23 23 6 42 1 14 51 43 44 46 29 41 15 18 15 2 28 45 3 2 17 28 45 10 53 13 5 63 35 11 4 37 11 53
800 800 800 800 800 800 800 800 800 800 1143 26 16 31 50 54 11 58 40 32 44 32 22 7 7 5 20 17 56 25 16 54 28 12 52 31 34 25 20 39 8 58 28 39 42 28 45 26 19 15 49 51 31 62 60 44 15 3 56 20 27 62 60 32 39 22 12 50 30 10 63 51 60 3 26 28 9 55 28 57 53 48 23 4 11 51 3 3 17 26 62 49 39 25 20 11 8 26 28 0
800 800 800 800 800 800 800 800 800 800 1143 26 56 63 28 49 3 60 50 58 16 61 35 58 2 43 6 0 13 1 5 12 15 1 42 21 28 55 35 60 45 36 45 34 23 43 19 52 38 43 22 3 21 40 44 28 26 8 42 9 50 54 35 51 11 4 9 9 14 20 25 19 37 2 43 55 36 56 45 20 39 39 18 39 54 55 6 50 43 25 6 63 1 56 8 52 2 61 39 39
800 800 800 800 800 800 800 800 800 800 1143 26 10 36 57 46 52 27 33 55 11 12 55 41 61 36 47 3 34 2 51 26 36 47 24 17 4 43 41 23 48 34 36 59 16 29 4 17 50 56 15 39 13 10 32 52 28 53 61 16 63 46 57 55 3 47 53 53 36 48 18 43 48 22 58 54 33 61 13 41 17 62 16 61 55 35 5 14 58 13 34 60 53 33 52 45 30 19 52 31
800 800 800 800 800 800 800 800 800 800 1143 26 8 58 51 21 30 16 37 6 27 21 60 23 46 38 22 20 46 35 1 4 20 53 30 53 27 21 38 29 63 63 11 35 19 53 62 25 23 63 2 6 57 10 59 25 3 23 48 36 32 21 31 53 50 6 18 25 19 41 60 36 60 9 2 27 18 16 57 63 59 9 10 18 17 32 31 49 38 5 46 62 5 29 27 33 51 23 51 28
800 800 800 800 800 800 800 800 800 800 1143 26 54 21 33 26 36 27 18 46 23 14 43 46 18 4 4 43 62 59 43 54 55 55 10 6 13 43 63 61 10 43 6 20 62 24 1 15 41 62 31 38 0 2 61 35 42 16 21 13 9 39 20 29 5 7 46 7 21 35 17 52 13 20 9 60 58 9 18 18 30 62 24 30 39 14 50 31 29 34 8 12 55 22 36 42 48 13 7 48
800 800 800 800 800 800 800 800 800 800 1143 26 15 29 28 40 54 30 37 21 61 36 26 48 48 63 55 2 6 12 21 46 18 52 50 33 30 42 27 27 0 12 45 49 51 28 10 41 44 32 9 7 34 62 50 58 50 42 41 43 61 59 60 44 31 42 13 1 27 48 44 63 51 62 24 7 26 31 29 47 11 33 16 26 58 42 6 8 43 9 10 6 13 24 3 28 49 25 50 43
800 800 800 800 800 800 800 800 800 800 1143 26 14 39 59 4 11 43 48 34 42 38 46 56 43 38 19 54 30 16 25 4 51 50 28 27 58 58 29 62 9 61 7 52 56 59 58 43 8 26 37 58 44 14 27 57 36 3 2 52 40 47 62 45 12 49 1 32 29 23 26 60 5 27 15 15 37 10 60 60 38 14 34 0 44 38 45 51 29 35 43 51 6 16 26 37 18 59 54 44
800 800 800 800 800 800 800 800 800 800 1143 26 28 18 6 15 2 13 46 25 43 30 53 30 8 29 13 63 10 30 53 18 13 21 7 15 2 44 27 51 41 23 23 46 25 43 56 0 63 56 10 20 0 49 43 42 43 22 29 23 16 38 30 53 11 2 54 6 26 57 51 29 56 31 22 17 1 60 1 33 37 52 34 53 37 35 9 39 62 60 61 39 1 40 52 63 13 56 63 16
800 800 800 800 800 800 800 800 800 800 1143 26 19 49 13 35 38 43 11 29 17 30 8 31 9 18 10 21 27 0 55 2 1 20 8 20 35 61 39 18 59 19 3 27 22 59 7 30 47 24 48 2 62 9 2 13 18 30 21 56 0 50 5 40 21 7 15 61 5 53 59 20 48 58 49 62 15 18 29 1 39 62 45 37 22 47 30 9 29 60 30 61 43 5 27 37 9 20 61 13
800 800 800 800 800 800 800 800 800 800 1143 26 9 20 58 28 9 7 42 19 20 15 41 54 36 58 31 22 63 13 7 26 6 61 16 30 43 27 10 29 25 27 61 56 26 44 14 41 43 55 47 62 4 40 4 39 18 44 42 8 46 43 29 39 41 22 63 25 18 42 19 12 44 51 4 26 48 45 33 0 17 9 54 41 63 32 1 21 44 4 1 49 1 36 5 38 12 13 2 43
800 800 800 800 800 800 800 800 800 800 1143 26 27 49 19 41 6 30 31 60 6 5 34 21 17 32 14 29 13 31 15 43 34 11 60 43 13 18 45 42 4 0 40 52 27 55 41 2 51 6 31 62 13 4 20 34 42 29 37 33 24 2 48 22 35 54 39 0 19 2 39 33 58 46 31 46 20 57 62 1 40 20 7 41 31 11 0 59 15 57 36 41 32 21 22 23 15 50 26 55
800 800 800 800 800 800 800 800 800 800 1143 26 35 20 63 52 53 20 1 8 10 42 11 47 40 22 34 31 45 58 43 26 47 18 44 15 1 59 20 35 22 2 16 7 43 23 31 24 62 9 17 26 0 32 53 26 11 62 22 61 36 52 59 41 2 60 33 32 42 11 61 50 61 15 0 16 53 27 45 3 10 54 23 59 55 20 53 55 22 39 29 16 24 21 21 57 22 5 29 41
800 800 800 800 800 800 800 800 800 800 1143 26 42 21 16 36 2 9 57 59 12 60 3 12 61 6 54 45 19 11 22 48 55 6 59 5 33 8 48 5 22 63 48 39 55 33 15 21 0 5 4 26 16 33 23 53 57 51 31 47 1 18 46 37 10 14 26 41 62 10 35 27 28 54 11 39 60 13 44 63 26 34 61 51 57 55 61 30 62 17 53 37 5 46 61 27 5 6 42 30
800 800 800 800 800 800 800 800 800 800 1143 26 44 17 28 12 56 49 46 22 44 43 29 22 50 40 63 13 1 28 32 29 26 47 22 33 10 14 8 37 46 27 32 46 61 28 35 15 0 36 12 57 29 3 2 40 39 59 63 34 59 12 12 8 42 53 23 8 23 60 16 47 58 21 54 5 44 39 59 31 25 33 43 21 23 11 55 62 23 61 62 26 32 55 53 31 42 34 33 23
800 800 800 800 800 800 800 800 800 800 1143 26 7 17 4 16 48 19 18 13 44 11 13 15 10 5 63 7 4 6 57 0 50 5 41 37 53 31 15 39 24 60 62 60 41 30 32 51 59 39 46 56 48 0 62 32 63 28 63 3 2 33 50 18 11 14 13 32 51 26 33 39 34 39 11 31 30 39 51 10 58 54 27 33 60 13 63 3 35 6 47 7 27 43 22 3 61 47 61 30
800 800 800 800 800 800 800 800 800 800 1143 26 7 34 40 21 45 42 32 44 33 2 28 34 6 61 18 38 27 24 15 34 36 20 47 52 35 15 54 41 12 16 11 49 19 4 54 39 29 27 12 29 17 21 50 45 54 22 32 16 46 33 1 22 5 29 57 29 51 49 20 14 23 48 49 34 5 28 38 18 4 1 26 62 33 52 18 1 10 38 21 52 25 36 34 36 42 28 33 57
800 800 800 800 800 800 800 800 800 800 1143 26 20 2 45 21 11 23 16 38 47 53 4 44 9 13 30 45 5 25 50 4 42 5 20 46 13 38 42 32 45 47 11 15 2 59 19 39 43 40 29 57 58 52 12 63 52 24 14 29 16 7 63 4 63 18 44 8 42 28 23 33 31 50 31 63 30 20 48 26 14 26 35 4 20 37 32 61 52 54 39 14 8 62 19 21 31 7 10 61
800 800 800 800 800 800 800 800 800 800 1143 26 3 14 4 24 40 58 48 9 59 25 25 35 55 12 55 35 61 23 23 38 20 3 21 12 44 24 48 63 27 46 53 45 57 11 48 47 8 28 43 52 21 62 17 58 38 7 0 50 13 18 59 14 28 15 51 34 52 0 12 1 22 29 37 45 55 24 8 26 48 34 45 45 44 25 25 19 1 28 39 62 23 39 37 23 34 5 63 17
800 800 800 800 800 800 800 800 800 800 1143 26 55 17 51 41 12 21 36 3 6 54 19 40 9 12 38 7 2 19 46 4 51 40 46 61 12 20 9 5 21 43 56 62 28 1 37 47 18 30 11 61 63 29 44 1 14 57 40 56 55 56 20 2 37 56 31 44 52 62 29 14 41 28 33 40 38 8 25 52 13 19 7 0 29 19 27 44 18 32 62 49 26 16 20 6 51 23 39 45
800 800 800 800 800 800 800 800 800 800 1143 26 41 10 55 4 3 36 50 9 12 8 59 4 44 31 57 33 33 49 60 5 27 43 44 53 10 14 3 11 47 53 12 18 43 62 54 48 3 16 54 11 47 45 7 46 5 51 28 2 32 12 0 47 37 42 58 14 14 0 57 61 43 1 11 39 47 16 52 18 24 30 9 39 24 24 34 49 2 42 18 56 32 12 5 58 3 39 46 62
800 800 800 800 800 800 800 800 800 800 1143 26 62 31 24 50 10 15 19 37 17 49 61 18 36 35 15 12 25 62 23 53 50 32 44 46 31 24 4 18 33 11 7 11 36 36 62 32 25 61 39 40 56 12 7 12 49 19 8 61 53 18 7 19 37 6 20 24 35 8 17 15 36 41 45 15 48 46 9 23 54 34 33 9 30 63 60 22 58 62 23 53 39 27 7 59 45 23 1 33
800 800 800 800 800 800 800 800 800 800 1143 26 0 27 58 24 44 28 32 30 30 56 4 57 52 48 15 4 22 6 56 33 57 46 41 60 49 38 43 23 40 20 7 38 30 51 49 39 53 8 28 44 54 34 42 54 24 53 5 57 34 40 36 17 24 60 26 7 13 26 61 25 54 35 41 49 56 32 24 29 29 43 1 19 57 63 17 9 6 61 60 61 22 15 2 44 28 0 40 3
800 800 800 800 800 800 800 800 800 800 1143 26 40 30 43 61 51 48 17 63 25 38 25 60 0 26 34 16 39 2 33 55 21 27 35 7 8 30 15 8 53 0 47 56 55 54 23 54 26 50 7 1 20 26 27 41 2 3 42 37 54 39 6 6 10 16 9 41 8 62 31 15 14 56 48 11 26 38 30 29 47 48 10 48 61 52 9 26 43 36 31 48 36 60 29 10 59 27 48 42
800 800 800 800 800 800 800 800 800 800 1143 26 44 32 13 58 58 27 33 20 31 11 11 55 26 49 49 27 19 61 55 11 49 6 54 42 51 48 36 27 33 44 56 38 30 54 31 42 37 53 14 37 6 58 56 9 57 39 39 0 53 44 13 30 19 33 15 19 3 55 38 30 1 48 61 23 63 43 4 54 32 2 52 25 51 30 27 5 48 1 44 39 8 36 30 6 38 24 60 14
800 800 800 800 800 800 800 800 800 800 1143 26 24 52 33 5 23 19 4 28 20 2 10 23 54 37 61 15 24 18 6 55 44 1 55 8 32 32 2 19 50 15 50 44 61 0 56 26 14 17 27 48 60 1 32 9 25 21 48 55 13 60 17 31 30 52 33 42 29 0 17 18 59 27 4 29 17 50 12 60 55 58 12 23 52 61 30 4 18 46 61 10 41 40 54 58 55 43 41 26
800 800 800 800 800 800 800 800 800 800 1143 26 16 5 51 16 31 21 9 22 51 0 50 49 22 17 4 1 44 53 17 53 20 51 6 16 58 34 21 0 13 29 60 20 17 39 4 40 35 56 12 29 23 44 4 37 42 14 6 39 28 11 15 11 9 51 60 16 13 13 49 17 8 8 40 0 27 34 9 55 16 51 37 15 60 1 19 63 8 9 27 14 58 14 23 61 7 36 61 20
800 800 800 800 800 800 800 800 800 800 1143 26 14 60 12 18 59 53 5 38 25 30 13 31 1 56 28 60 12 27 58 32 50 4 7 23 31 35 39 45 63 30 9 16 51 9 3 1 63 63 7 60 61 9 62 48 59 6 60 16 16 8 5 59 6 23 60 44 25 57 42 62 13 13 51 36 12 44 9 49 61 3 20 30 3 10 48 27 4 47 40 8 37 41 9 26 38 3 23 52
800 800 800 800 800 800 800 800 800 800 1143 26 46 39 33 12 16 0 37 60 18 16 24 3 58 12 54 40 5 42 46 11 57 25 29 47 50 57 63 54 51 38 22 50 58 10 29 23 20 53 45 11 30 41 14 0 14 36 22 59 50 27 40 12 31 57 5 57 37 5 27 59 10 20 24 30 22 17 45 4 11 62 18 41 38 6 61 60 40 46 19 28 26 43 46 26 3 10 40 16
0 0 0 0 0 0 0 0 0 0 0 0 0 0 0 0 0 0 0 0 0 0 0 0 0 0 0 0 0 0 0 0 0 0 0 0 0 0 0 0 0 0 0 0 0 0 0 0 0 0 0 0 0 0 0 0 0 0 0 0 0 0 0 0 0 0 0 0 0 0 0 0 0 0 0 0 0 0 0 0 0 0 0 0 0 0 0 0 0 0 0 0 0 0 0 0 0 0 0 0
0 0 0 0 0 0 0 0 0 0 0 0 0 0 0 0 0 0 0 0 0 0 0 0 0 0 0 0 0 0 0 0 0 0 0 0 0 0 0 0 0 0 0 0 0 0 0 0 0 0 0 0 0 0 0 0 0 0 0 0 0 0 0 0 0 0 0 0 0 0 0 0 0 0 0 0 0 0 0 0 0 0 0 0 0 0 0 0 0 0 0 0 0 0 0 0 0 0 0 0
0 0 0 0 0 0 0 0 0 0 0 0 0 0 0 0 0 0 0 0 0 0 0 0 0 0 0 0 0 0 0 0 0 0 0 0 0 0 0 0 0 0 0 0 0 0 0 0 0 0 0 0 0 0 0 0 0 0 0 0 0 0 0 0 0 0 0 0 0 0 0 0 0 0 0 0 0 0 0 0 0 0 0 0 0 0 0 0 0 0 0 0 0 0 0 0 0 0 0 0
0 0 0 0 0 0 0 0 0 0 0 0 0 0 0 0 0 0 0 0 0 0 0 0 0 0 0 0 0 0 0 0 0 0 0 0 0 0 0 0 0 0 0 0 0 0 0 0 0 0 0 0 0 0 0 0 0 0 0 0 0 0 0 0 0 0 0 0 0 0 0 0 0 0 0 0 0 0 0 0 0 0 0 0 0 0 0 0 0 0 0 0 0 0 0 0 0 0 0 0
0 0 0 0 0 0 0 0 0 0 0 0 0 0 0 0 0 0 0 0 0 0 0 0 0 0 0 0 0 0 0 0 0 0 0 0 0 0 0 0 0 0 0 0 0 0 0 0 0 0 0 0 0 0 0 0 0 0 0 0 0 0 0 0 0 0 0 0 0 0 0 0 0 0 0 0 0 0 0 0 0 0 0 0 0 0 0 0 0 0 0 0 0 0 0 0 0 0 0 0
0 0 0 0 0 0 0 0 0 0 0 0 0 0 0 0 0 0 0 0 0 0 0 0 0 0 0 0 0 0 0 0 0 0 0 0 0 0 0 0 0 0 0 0 0 0 0 0 0 0 0 0 0 0 0 0 0 0 0 0 0 0 0 0 0 0 0 0 0 0 0 0 0 0 0 0 0 0 0 0 0 0 0 0 0 0 0 0 0 0 0 0 0 0 0 0 0 0 0 0
0 0 0 0 0 0 0 0 0 0 0 0 0 0 0 0 0 0 0 0 0 0 0 0 0 0 0 0 0 0 0 0 0 0 0 0 0 0 0 0 0 0 0 0 0 0 0 0 0 0 0 0 0 0 0 0 0 0 0 0 0 0 0 0 0 0 0 0 0 0 0 0 0 0 0 0 0 0 0 0 0 0 0 0 0 0 0 0 0 0 0 0 0 0 0 0 0 0 0 0
0 0 0 0 0 0 0 0 0 0 0 0 0 0 0 0 0 0 0 0 0 0 0 0 0 0 0 0 0 0 0 0 0 0 0 0 0 0 0 0 0 0 0 0 0 0 0 0 0 0 0 0 0 0 0 0 0 0 0 0 0 0 0 0 0 0 0 0 0 0 0 0 0 0 0 0 0 0 0 0 0 0 0 0 0 0 0 0 0 0 0 0 0 0 0 0 0 0 0 0
0 0 0 0 0 0 0 0 0 0 0 0 0 0 0 0 0 0 0 0 0 0 0 0 0 0 0 0 0 0 0 0 0 0 0 0 0 0 0 0 0 0 0 0 0 0 0 0 0 0 0 0 0 0 0 0 0 0 0 0 0 0 0 0 0 0 0 0 0 0 0 0 0 0 0 0 0 0 0 0 0 0 0 0 0 0 0 0 0 0 0 0 0 0 0 0 0 0 0 0
0 0 0 0 0 0 0 0 0 0 0 0 0 0 0 0 0 0 0 0 0 0 0 0 0 0 0 0 0 0 0 0 0 0 0 0 0 0 0 0 0 0 0 0 0 0 0 0 0 0 0 0 0 0 0 0 0 0 0 0 0 0 0 0 0 0 0 0 0 0 0 0 0 0 0 0 0 0 0 0 0 0 0 0 0 0 0 0 0 0 0 0 0 0 0 0 0 0 0 0
0 0 0 0 0 0 0 0 0 0 0 0 0 0 0 0 0 0 0 0 0 0 0 0 0 0 0 0 0 0 0 0 0 0 0 0 0 0 0 0 0 0 0 0 0 0 0 0 0 0 0 0 0 0 0 0 0 0 0 0 0 0 0 0 0 0 0 0 0 0 0 0 0 0 0 0 0 0 0 0 0 0 0 0 0 0 0 0 0 0 0 0 0 0 0 0 0 0 0 0
0 0 0 0 0 0 0 0 0 0 0 0 0 0 0 0 0 0 0 0 0 0 0 0 0 0 0 0 0 0 0 0 0 0 0 0 0 0 0 0 0 0 0 0 0 0 0 0 0 0 0 0 0 0 0 0 0 0 0 0 0 0 0 0 0 0 0 0 0 0 0 0 0 0 0 0 0 0 0 0 0 0 0 0 0 0 0 0 0 0 0 0 0 0 0 0 0 0 0 0
0 0 0 0 0 0 0 0 0 0 0 0 0 0 0 0 0 0 0 0 0 0 0 0 0 0 0 0 0 0 0 0 0 0 0 0 0 0 0 0 0 0 0 0 0 0 0 0 0 0 0 0 0 0 0 0 0 0 0 0 0 0 0 0 0 0 0 0 0 0 0 0 0 0 0 0 0 0 0 0 0 0 0 0 0 0 0 0 0 0 0 0 0 0 0 0 0 0 0 0
0 0 0 0 0 0 0 0 0 0 0 0 0 0 0 0 0 0 0 0 0 0 0 0 0 0 0 0 0 0 0 0 0 0 0 0 0 0 0 0 0 0 0 0 0 0 0 0 0 0 0 0 0 0 0 0 0 0 0 0 0 0 0 0 0 0 0 0 0 0 0 0 0 0 0 0 0 0 0 0 0 0 0 0 0 0 0 0 0 0 0 0 0 0 0 0 0 0 0 0
0 0 0 0 0 0 0 0 0 0 0 0 0 0 0 0 0 0 0 0 0 0 0 0 0 0 0 0 0 0 0 0 0 0 0 0 0 0 0 0 0 0 0 0 0 0 0 0 0 0 0 0 0 0 0 0 0 0 0 0 0 0 0 0 0 0 0 0 0 0 0 0 0 0 0 0 0 0 0 0 0 0 0 0 0 0 0 0 0 0 0 0 0 0 0 0 0 0 0 0
0 0 0 0 0 0 0 0 0 0 0 0 0 0 0 0 0 0 0 0 0 0 0 0 0 0 0 0 0 0 0 0 0 0 0 0 0 0 0 0 0 0 0 0 0 0 0 0 0 0 0 0 0 0 0 0 0 0 0 0 0 0 0 0 0 0 0 0 0 0 0 0 0 0 0 0 0 0 0 0 0 0 0 0 0 0 0 0 0 0 0 0 0 0 0 0 0 0 0 0
0 0 0 0 0 0 0 0 0 0 0 0 0 0 0 0 0 0 0 0 0 0 0 0 0 0 0 0 0 0 0 0 0 0 0 0 0 0 0 0 0 0 0 0 0 0 0 0 0 0 0 0 0 0 0 0 0 0 0 0 0 0 0 0 0 0 0 0 0 0 0 0 0 0 0 0 0 0 0 0 0 0 0 0 0 0 0 0 0 0 0 0 0 0 0 0 0 0 0 0
0 0 0 0 0 0 0 0 0 0 0 0 0 0 0 0 0 0 0 0 0 0 0 0 0 0 0 0 0 0 0 0 0 0 0 0 0 0 0 0 0 0 0 0 0 0 0 0 0 0 0 0 0 0 0 0 0 0 0 0 0 0 0 0 0 0 0 0 0 0 0 0 0 0 0 0 0 0 0 0 0 0 0 0 0 0 0 0 0 0 0 0 0 0 0 0 0 0 0 0
0 0 0 0 0 0 0 0 0 0 0 0 0 0 0 0 0 0 0 0 0 0 0 0 0 0 0 0 0 0 0 0 0 0 0 0 0 0 0 0 0 0 0 0 0 0 0 0 0 0 0 0 0 0 0 0 0 0 0 0 0 0 0 0 0 0 0 0 0 0 0 0 0 0 0 0 0 0 0 0 0 0 0 0 0 0 0 0 0 0 0 0 0 0 0 0 0 0 0 0
0 0 0 0 0 0 0 0 0 0 0 0 0 0 0 0 0 0 0 0 0 0 0 0 0 0 0 0 0 0 0 0 0 0 0 0 0 0 0 0 0 0 0 0 0 0 0 0 0 0 0 0 0 0 0 0 0 0 0 0 0 0 0 0 0 0 0 0 0 0 0 0 0 0 0 0 0 0 0 0 0 0 0 0 0 0 0 0 0 0 0 0 0 0 0 0 0 0 0 0
0 0 0 0 0 0 0 0 0 0 0 0 0 0 0 0 0 0 0 0 0 0 0 0 0 0 0 0 0 0 0 0 0 0 0 0 0 0 0 0 0 0 0 0 0 0 0 0 0 0 0 0 0 0 0 0 0 0 0 0 0 0 0 0 0 0 0 0 0 0 0 0 0 0 0 0 0 0 0 0 0 0 0 0 0 0 0 0 0 0 0 0 0 0 0 0 0 0 0 0
0 0 0 0 0 0 0 0 0 0 0 0 0 0 0 0 0 0 0 0 0 0 0 0 0 0 0 0 0 0 0 0 0 0 0 0 0 0 0 0 0 0 0 0 0 0 0 0 0 0 0 0 0 0 0 0 0 0 0 0 0 0 0 0 0 0 0 0 0 0 0 0 0 0 0 0 0 0 0 0 0 0 0 0 0 0 0 0 0 0 0 0 0 0 0 0 0 0 0 0
0 0 0 0 0 0 0 0 0 0 0 0 0 0 0 0 0 0 0 0 0 0 0 0 0 0 0 0 0 0 0 0 0 0 0 0 0 0 0 0 0 0 0 0 0 0 0 0 0 0 0 0 0 0 0 0 0 0 0 0 0 0 0 0 0 0 0 0 0 0 0 0 0 0 0 0 0 0 0 0 0 0 0 0 0 0 0 0 0 0 0 0 0 0 0 0 0 0 0 0
0 0 0 0 0 0 0 0 0 0 0 0 0 0 0 0 0 0 0 0 0 0 0 0 0 0 0 0 0 0 0 0 0 0 0 0 0 0 0 0 0 0 0 0 0 0 0 0 0 0 0 0 0 0 0 0 0 0 0 0 0 0 0 0 0 0 0 0 0 0 0 0 0 0 0 0 0 0 0 0 0 0 0 0 0 0 0 0 0 0 0 0 0 0 0 0 0 0 0 0
0 0 0 0 0 0 0 0 0 0 0 0 0 0 0 0 0 0 0 0 0 0 0 0 0 0 0 0 0 0 0 0 0 0 0 0 0 0 0 0 0 0 0 0 0 0 0 0 0 0 0 0 0 0 0 0 0 0 0 0 0 0 0 0 0 0 0 0 0 0 0 0 0 0 0 0 0 0 0 0 0 0 0 0 0 0 0 0 0 0 0 0 0 0 0 0 0 0 0 0
0 0 0 0 0 0 0 0 0 0 0 0 0 0 0 0 0 0 0 0 0 0 0 0 0 0 0 0 0 0 0 0 0 0 0 0 0 0 0 0 0 0 0 0 0 0 0 0 0 0 0 0 0 0 0 0 0 0 0 0 0 0 0 0 0 0 0 0 0 0 0 0 0 0 0 0 0 0 0 0 0 0 0 0 0 0 0 0 0 0 0 0 0 0 0 0 0 0 0 0
0 0 0 0 0 0 0 0 0 0 0 0 0 0 0 0 0 0 0 0 0 0 0 0 0 0 0 0 0 0 0 0 0 0 0 0 0 0 0 0 0 0 0 0 0 0 0 0 0 0 0 0 0 0 0 0 0 0 0 0 0 0 0 0 0 0 0 0 0 0 0 0 0 0 0 0 0 0 0 0 0 0 0 0 0 0 0 0 0 0 0 0 0 0 0 0 0 0 0 0
0 0 0 0 0 0 0 0 0 0 0 0 0 0 0 0 0 0 0 0 0 0 0 0 0 0 0 0 0 0 0 0 0 0 0 0 0 0 0 0 0 0 0 0 0 0 0 0 0 0 0 0 0 0 0 0 0 0 0 0 0 0 0 0 0 0 0 0 0 0 0 0 0 0 0 0 0 0 0 0 0 0 0 0 0 0 0 0 0 0 0 0 0 0 0 0 0 0 0 0
0 0 0 0 0 0 0 0 0 0 0 0 0 0 0 0 0 0 0 0 0 0 0 0 0 0 0 0 0 0 0 0 0 0 0 0 0 0 0 0 0 0 0 0 0 0 0 0 0 0 0 0 0 0 0 0 0 0 0 0 0 0 0 0 0 0 0 0 0 0 0 0 0 0 0 0 0 0 0 0 0 0 0 0 0 0 0 0 0 0 0 0 0 0 0 0 0 0 0 0
0 0 0 0 0 0 0 0 0 0 0 0 0 0 0 0 0 0 0 0 0 0 0 0 0 0 0 0 0 0 0 0 0 0 0 0 0 0 0 0 0 0 0 0 0 0 0 0 0 0 0 0 0 0 0 0 0 0 0 0 0 0 0 0 0 0 0 0 0 0 0 0 0 0 0 0 0 0 0 0 0 0 0 0 0 0 0 0 0 0 0 0 0 0 0 0 0 0 0 0
0 0 0 0 0 0 0 0 0 0 0 0 0 0 0 0 0 0 0 0 0 0 0 0 0 0 0 0 0 0 0 0 0 0 0 0 0 0 0 0 0 0 0 0 0 0 0 0 0 0 0 0 0 0 0 0 0 0 0 0 0 0 0 0 0 0 0 0 0 0 0 0 0 0 0 0 0 0 0 0 0 0 0 0 0 0 0 0 0 0 0 0 0 0 0 0 0 0 0 0
0 0 0 0 0 0 0 0 0 0 0 0 0 0 0 0 0 0 0 0 0 0 0 0 0 0 0 0 0 0 0 0 0 0 0 0 0 0 0 0 0 0 0 0 0 0 0 0 0 0 0 0 0 0 0 0 0 0 0 0 0 0 0 0 0 0 0 0 0 0 0 0 0 0 0 0 0 0 0 0 0 0 0 0 0 0 0 0 0 0 0 0 0 0 0 0 0 0 0 0
0 0 0 0 0 0 0 0 0 0 0 0 0 0 0 0 0 0 0 0 0 0 0 0 0 0 0 0 0 0 0 0 0 0 0 0 0 0 0 0 0 0 0 0 0 0 0 0 0 0 0 0 0 0 0 0 0 0 0 0 0 0 0 0 0 0 0 0 0 0 0 0 0 0 0 0 0 0 0 0 0 0 0 0 0 0 0 0 0 0 0 0 0 0 0 0 0 0 0 0
0 0 0 0 0 0 0 0 0 0 0 0 0 0 0 0 0 0 0 0 0 0 0 0 0 0 0 0 0 0 0 0 0 0 0 0 0 0 0 0 0 0 0 0 0 0 0 0 0 0 0 0 0 0 0 0 0 0 0 0 0 0 0 0 0 0 0 0 0 0 0 0 0 0 0 0 0 0 0 0 0 0 0 0 0 0 0 0 0 0 0 0 0 0 0 0 0 0 0 0
0 0 0 0 0 0 0 0 0 0 0 0 0 0 0 0 0 0 0 0 0 0 0 0 0 0 0 0 0 0 0 0 0 0 0 0 0 0 0 0 0 0 0 0 0 0 0 0 0 0 0 0 0 0 0 0 0 0 0 0 0 0 0 0 0 0 0 0 0 0 0 0 0 0 0 0 0 0 0 0 0 0 0 0 0 0 0 0 0 0 0 0 0 0 0 0 0 0 0 0
0 0 0 0 0 0 0 0 0 0 0 0 0 0 0 0 0 0 0 0 0 0 0 0 0 0 0 0 0 0 0 0 0 0 0 0 0 0 0 0 0 0 0 0 0 0 0 0 0 0 0 0 0 0 0 0 0 0 0 0 0 0 0 0 0 0 0 0 0 0 0 0 0 0 0 0 0 0 0 0 0 0 0 0 0 0 0 0 0 0 0 0 0 0 0 0 0 0 0 0
0 0 0 0 0 0 0 0 0 0 0 0 0 0 0 0 0 0 0 0 0 0 0 0 0 0 0 0 0 0 0 0 0 0 0 0 0 0 0 0 0 0 0 0 0 0 0 0 0 0 0 0 0 0 0 0 0 0 0 0 0 0 0 0 0 0 0 0 0 0 0 0 0 0 0 0 0 0 0 0 0 0 0 0 0 0 0 0 0 0 0 0 0 0 0 0 0 0 0 0
0 0 0 0 0 0 0 0 0 0 0 0 0 0 0 0 0 0 0 0 0 0 0 0 0 0 0 0 0 0 0 0 0 0 0 0 0 0 0 0 0 0 0 0 0 0 0 0 0 0 0 0 0 0 0 0 0 0 0 0 0 0 0 0 0 0 0 0 0 0 0 0 0 0 0 0 0 0 0 0 0 0 0 0 0 0 0 0 0 0 0 0 0 0 0 0 0 0 0 0
0 0 0 0 0 0 0 0 0 0 0 0 0 0 0 0 0 0 0 0 0 0 0 0 0 0 0 0 0 0 0 0 0 0 0 0 0 0 0 0 0 0 0 0 0 0 0 0 0 0 0 0 0 0 0 0 0 0 0 0 0 0 0 0 0 0 0 0 0 0 0 0 0 0 0 0 0 0 0 0 0 0 0 0 0 0 0 0 0 0 0 0 0 0 0 0 0 0 0 0
0 0 0 0 0 0 0 0 0 0 0 0 0 0 0 0 0 0 0 0 0 0 0 0 0 0 0 0 0 0 0 0 0 0 0 0 0 0 0 0 0 0 0 0 0 0 0 0 0 0 0 0 0 0 0 0 0 0 0 0 0 0 0 0 0 0 0 0 0 0 0 0 0 0 0 0 0 0 0 0 0 0 0 0 0 0 0 0 0 0 0 0 0 0 0 0 0 0 0 0
0 0 0 0 0 0 0 0 0 0 0 0 0 0 0 0 0 0 0 0 0 0 0 0 0 0 0 0 0 0 0 0 0 0 0 0 0 0 0 0 0 0 0 0 0 0 0 0 0 0 0 0 0 0 0 0 0 0 0 0 0 0 0 0 0 0 0 0 0 0 0 0 0 0 0 0 0 0 0 0 0 0 0 0 0 0 0 0 0 0 0 0 0 0 0 0 0 0 0 0
0 0 0 0 0 0 0 0 0 0 0 0 0 0 0 0 0 0 0 0 0 0 0 0 0 0 0 0 0 0 0 0 0 0 0 0 0 0 0 0 0 0 0 0 0 0 0 0 0 0 0 0 0 0 0 0 0 0 0 0 0 0 0 0 0 0 0 0 0 0 0 0 0 0 0 0 0 0 0 0 0 0 0 0 0 0 0 0 0 0 0 0 0 0 0 0 0 0 0 0
0 0 0 0 0 0 0 0 0 0 0 0 0 0 0 0 0 0 0 0 0 0 0 0 0 0 0 0 0 0 0 0 0 0 0 0 0 0 0 0 0 0 0 0 0 0 0 0 0 0 0 0 0 0 0 0 0 0 0 0 0 0 0 0 0 0 0 0 0 0 0 0 0 0 0 0 0 0 0 0 0 0 0 0 0 0 0 0 0 0 0 0 0 0 0 0 0 0 0 0
0 0 0 0 0 0 0 0 0 0 0 0 0 0 0 0 0 0 0 0 0 0 0 0 0 0 0 0 0 0 0 0 0 0 0 0 0 0 0 0 0 0 0 0 0 0 0 0 0 0 0 0 0 0 0 0 0 0 0 0 0 0 0 0 0 0 0 0 0 0 0 0 0 0 0 0 0 0 0 0 0 0 0 0 0 0 0 0 0 0 0 0 0 0 0 0 0 0 0 0
0 0 0 0 0 0 0 0 0 0 0 0 0 0 0 0 0 0 0 0 0 0 0 0 0 0 0 0 0 0 0 0 0 0 0 0 0 0 0 0 0 0 0 0 0 0 0 0 0 0 0 0 0 0 0 0 0 0 0 0 0 0 0 0 0 0 0 0 0 0 0 0 0 0 0 0 0 0 0 0 0 0 0 0 0 0 0 0 0 0 0 0 0 0 0 0 0 0 0 0
0 0 0 0 0 0 0 0 0 0 0 0 0 0 0 0 0 0 0 0 0 0 0 0 0 0 0 0 0 0 0 0 0 0 0 0 0 0 0 0 0 0 0 0 0 0 0 0 0 0 0 0 0 0 0 0 0 0 0 0 0 0 0 0 0 0 0 0 0 0 0 0 0 0 0 0 0 0 0 0 0 0 0 0 0 0 0 0 0 0 0 0 0 0 0 0 0 0 0 0
0 0 0 0 0 0 0 0 0 0 0 0 0 0 0 0 0 0 0 0 0 0 0 0 0 0 0 0 0 0 0 0 0 0 0 0 0 0 0 0 0 0 0 0 0 0 0 0 0 0 0 0 0 0 0 0 0 0 0 0 0 0 0 0 0 0 0 0 0 0 0 0 0 0 0 0 0 0 0 0 0 0 0 0 0 0 0 0 0 0 0 0 0 0 0 0 0 0 0 0
0 0 0 0 0 0 0 0 0 0 0 0 0 0 0 0 0 0 0 0 0 0 0 0 0 0 0 0 0 0 0 0 0 0 0 0 0 0 0 0 0 0 0 0 0 0 0 0 0 0 0 0 0 0 0 0 0 0 0 0 0 0 0 0 0 0 0 0 0 0 0 0 0 0 0 0 0 0 0 0 0 0 0 0 0 0 0 0 0 0 0 0 0 0 0 0 0 0 0 0
0 0 0 0 0 0 0 0 0 0 0 0 0 0 0 0 0 0 0 0 0 0 0 0 0 0 0 0 0 0 0 0 0 0 0 0 0 0 0 0 0 0 0 0 0 0 0 0 0 0 0 0 0 0 0 0 0 0 0 0 0 0 0 0 0 0 0 0 0 0 0 0 0 0 0 0 0 0 0 0 0 0 0 0 0 0 0 0 0 0 0 0 0 0 0 0 0 0 0 0
0 0 0 0 0 0 0 0 0 0 0 0 0 0 0 0 0 0 0 0 0 0 0 0 0 0 0 0 0 0 0 0 0 0 0 0 0 0 0 0 0 0 0 0 0 0 0 0 0 0 0 0 0 0 0 0 0 0 0 0 0 0 0 0 0 0 0 0 0 0 0 0 0 0 0 0 0 0 0 0 0 0 0 0 0 0 0 0 0 0 0 0 0 0 0 0 0 0 0 0